1 13 31
##############################
##############################
#p     ** * 1  *   *  * * *  #
# # # #*# #*#*#*# # # #*#*#*##
#    d    **s2 *      *   * *#
# # # # # #*# # #*#*# # # # ##
#        f  3**  *  *    w   #
# # # # # # # # # #*# #*# # ##
#*  *      *  *    4 *       #
# # # # #*# # # #*#*# # # # ##
#*    **  *  t    *5   x     #
# #*# # # # # # #*# # # # # ##
#   b       *   *  *6        #
##############################