3 13 31
##############################
##############################
#p       *    **      *   1  #
# # # #s# # # # # #*# #*# # ##
#    *       5** 6  d     1  #
# #b# # # #*# # #*# # # # # ##
#  *        *5f  6    *      #
# # # # # # # # # #*# #2# # ##
#  t  *  *      s **         #
#*#*# # # # #*# # # # #2# #*##
#    * b     4   *     3*    #
# # # # # #*#4#3#*#w# # #*# ##
##############################
##############################