4 13 31
##############################
##############################
#p  x   * * d  * 1 *1 * *1   #
# # # #*# # #*#*# # # #*#*#*##
#     w   ***  *   5  *  2* *#
# # # # # #*# # #*#*# # # # ##
# *  s  5    **  *  *    2   #
# # # # # # # # # #*# #*# # ##
#*     f   *  * 4 4  *   2   #
# # # # #*# # # #*#*# # # # ##
#*    **  * t     *    3x3   #
# #*# # # # #6# #*# #b# # # ##
#    **  b6 *   *  *     3   #
##############################