5 13 31
##############################
##############################
#p    **d     *      *  *6   #
# # # #*# # # # # # # # #5# ##
#   *   * 1   *  *   *  w *  #
# # # # # # # # # # # # #5# ##
# *     *    * t 22  *  **   #
# # # # # # # #4# # # # # # ##
#    *     *1  4   2 *   5   #
# # # # # # # # # # # # # # ##
#  * * f    1  4s *3     6   #
# # # # # # #3# #3# #b#6# # ##
##############################
##############################