2 13 31
##############################
##############################
#p      * *    * 1 *  *6* *  #
# # # # # # #*#*# # # #*#*#*##
#   *  *f * *  * 1  b *   * *#
# # # # # #*# # #*#*# # # # ##
#         s  **  *2 *    5 t #
# # # # # # # # # #*# #*# # ##
#*  *      *  *  f2  *   4   #
# # # # #*# # # #*#*# # # # ##
#*    **  *w  x   * 3 3      #
# #*# # # # # # #*# # #d# # ##
##############################
##############################