4 13 31
##############################
#p  x 1 * *    *   *  * *    #
# # # #*# # #*#*# # # #*#*#*##
#  f      ***  *      *   * *#
# # # # # #*# # #*#*# # # # ##
# *          **  *  *        #
# # # # # # # # # #*# #*# # ##
#*  f      *  *      *       #
# # # # #*# # # #*#*# # # # ##
#*    **  *       *          #
# #*# # # # # # #*# #b# # # ##
#    **     *   *  *         #
##############################