2 13 31
##############################
#p      * *    *   *  * * *  #
# # # # # # #*#*# # # #*#*#*##
#   *  *f * *  * 1    *   * *#
# # # #x# #*# # #*#*# # # # ##
#       2    **  *  *  2     #
# # # # # # # # # #*# #*# # ##
#*  *      *  *      *       #
# # # # #*# # # #*#*# # # # ##
#*    **  *   x   *      3   #
# #*# # # # # # #*# # # # # ##
#     3     *   *  *  4      #
##############################