3 13 31
##############################
#p       *    **  2   *      #
# # # #s# # # # # #*# #*# # ##
#    *        **             #
# #b# # # #*# # #*# # # # # ##
#  *     3  *    1    *      #
# # # # # # # # # #*# # # # ##
#     *  *        **   4 x   #
#*#*# # # # #*# # # # # # #*##
#    *     4     *   5  *    #
# # # # # #*# #2#*# # # #*# ##
#*      *        *        *  #
##############################