1 13 31
##############################
#p     ** *    *   *  * * *  #
# # # #*# # #*#*# # # #*#*#*##
# s *   5 ***  *      *   * *#
#f# # # # #*# # #*#*# # # # ##
#      t   x **  *  *   1    #
# # # # # # # # # #*# #*# # ##
#*  *      *  *      *       #
# # # # #*# # # #*#*# # # # ##
#*    **  *       *          #
# #*# # # # # # #*# # # # # ##
#           *   *  *         #
##############################