1 13 31
##############################
#p     ** *   5*  b*  * * *  #
# # # #*# #*#*#*# # # #*#*#*##
#   t    6***  *      *   * *#
#f# # # # #*# # #*#*# # # # ##
#     s    x **  *  *   1    #
# # # # # # # # # #*# #*# # ##
#*  *    3 *f *      *       #
# # # # #*# # # #*#*# # # # ##
#*  4 **  *       *    d 2   #
# #*# # # # # # #*# # # # # ##
#         w *   *  *         #
##############################