1 13 30
##############################
#p    **   1 *   *  *  * *   #
# # # *#  #*#*# # # ##*#*#*# #
#   *    **  *  1   **   * * #
# # #  # *# # #*#*# ## # # #*#
#f       x **  *  *    1     #
# # #  #  # # # #*# ##*# # # #
#*  *    *  *      * *       #
# # #  #* # # #*#*# ## # # # #
#*    *         *            #
# #*#  #  # # #*# # ## # # # #
#       2 *   *  *           #
##############################