4 13 31
##############################
##############################
#p  x   * * d  * 1 *  * *    #
# # # #*# # #*#*# # # #*#*#*##
#     w   *** 4*      *   * *#
# # # # # #*# # #*#*# # # # ##
# *  s       **  *  *  2     #
# # # # # # # # # #*# #*# # ##
#*     f   *  *      *   3   #
# # # # #*# # # #*#*# # # # ##
#*    **  * t  5  *  5  x    #
# #*# # # #b#6# #*# #b# # # ##
##############################
##############################