3 13 31
##############################
##############################
#p       *    **  2   *      #
# # # #s# # # # # #*# #*# # ##
#    *        **    d        #
# #b# # # #*# # #*# # # # # ##
#  *     3  * f  1    *      #
# # # # # # # # # #*# # # # ##
#  t  *  *      s **   4 x   #
#*#*# # # # #*# # # # # # #*##
#    * b   4     *   5  *    #
# # # #w# #*# #2#*# # # #*# ##
##############################
##############################