1 13 31
##############################
#p  t  ** *    *   *  * * *  #
# # # #*# # #*#*# # # #*#*#*##
#   *    6***  *      *   * *#
#f# # # # #*# # #*#*# # # # ##
#     st   x **  *  *   1    #
# # # # # # # # # #*# #*# # ##
#*  *      *  *      *       #
# # # # #*# # # #*#*# # # # ##
#*    **  *       *          #
# #*# # # # # # #*# # # # # ##
#           *   *  *         #
##############################