5 13 32
################################
#p                             #
# # # #*# # # ## # # # # # # # #
#      x                       #
# # # # # # # ## # # # # # # # #
#                              #
# # # # # # # ## # # # # # # # #
#                              #
# # # # # # # ## # # #1# # # # #
#                              #
# # # # # # # ## # # # # # # # #
#                              #
################################