5 13 32
################################
#p          3                  #
# # # #*# # # ## # # # # # # # #
#      x                       #
# # # # # # # ## # # # # # # # #
#                              #
# # # # # # # ## # # # # # # # #
#                              #
# # # # # # # ## # # #1# # # # #
#               2              #
# # # # # # # ## # # # # # # # #
#                              #
################################