5 13 31
##############################
##############################
#p    **d     *      *  *    #
# # # #*# # # # # # # # # # ##
#   *   *  2  *  *   *  w *  #
# # # # # # # # # # # # # # ##
# *     *    * t  4  *  **   #
# # # # # # # # # # # # # # ##
#    *  3  *   6     *  5    #
# # # # # # # # # # # # # # ##
#  * * f     *  s *     6    #
# # # # # # # # # # # # # # ##
#    *      *        b    *  #
##############################