4 13 31
##############################
#p  x   * *    * 1 *  * *    #
# # # #*# # #*#*# # # #*#*#*##
#         *** 4*      *   * *#
# # # # # #*# # #*#*# # # # ##
# *          **  *  *  2     #
# # # # # # # # # #*# #*# # ##
#*         *  *      *   3   #
# # # # #*# # # #*#*# # # # ##
#*    **  *    5  *  5  x    #
# #*# # # # # # #*# #b# # # ##
#    **     *   *  *   6     #
##############################