1 13 31
##############################
##############################
#p     ** *    * 1 *  * * *  #
# # # #*# #*#*#*# # # #*#*#*##
#    d   1**s  *      *   * *#
# # # # # #*# # #*#*# # # # ##
#   1    f   **  *  *    w   #
# # # # # # # # # #*# #*# # ##
#*  *      *  *     2*       #
# # # # #*# # # #*#*# # # # ##
#*    **  *  t    *   x 3    #
# #*#b# #2# # # #*# # #2# # ##
##############################
##############################