1 13 32
################################
#p     ** *  1 *   *  *  * *   #
# # # #*# # #*#*# # # ##*#*#*# #
#   *     ***  *  1   **   * * #
# # # # # #*# # #*#*# ## # # #*#
#f         x **  *  *    1     #
# # # # # # # # # #*# ##*# # # #
#*  *      *  *      * *       #
# # # # #*# # # #*#*# ## # # # #
#*    **  *       *            #
# #*# # # # # # #*# # ## # # # #
#        2  *   *  *           #
################################