2 13 30
##############################
#p     b**    *   *  * * *   #
# # # # ## #*#*# # # #*#*#*# #
#   *  *f* *  *      *   * * #
# #b# #x##*# # #*#*# # # # #*#
#f   s      **  *  *         #
# # # # ## # # # #*# #*# # # #
#*  *   s *  *      *        #
# # # # ## # # #*#*# # # # # #
#*    ** *       *           #
# #*# # ## # # #*# # # # # # #
#          *   *  *          #
##############################