4 13 30
##############################
#p  x 1 * *    * **  * *     #
# # # #*# # #*#*## # #*#*#*# #
#  f      ***  * *   *   * * #
# # # # # #*# # ##*# # # # #*#
# *          **    *         #
# # # # # # # # ##*# #*# # # #
#*  f      *  *     *        #
# # # # #*# # # ##*# # # # # #
#*    **  *      *           #
# #*# # # # # # ## #b# # # # #
#    **     *   * *          #
##############################