2 13 31
##############################
#p      * *    *   *  * * *  #
# # # # # # #*#*# # # #*#*#*##
#   *  *f * *  * 1  b *   * *#
# # # #x# #*# # #*#*# # # # ##
#       2 s  **  *  *  2   t #
# # # # # # # # # #*# #*# # ##
#*  *      *  *  f   *       #
# # # # #*# # # #*#*# # # # ##
#*    **  *w  x   *      3   #
# #*# # # # # # #*# # # # # ##
#     3     *   *  *  4 d    #
##############################