2 13 32
################################
#p     b** *    *   *  * * *   #
# # # # #* # #*#*# # # #*#*#*# #
#   *  *f* * *  *      *   * * #
# #b# #x#  #*# # #*#*# # # # #*#
#f   s        **  *  *         #
# # # # #  # # # # #*# #*# # # #
#*  *   s   *  *      *        #
# # # # # *# # # #*#*# # # # # #
#*    **   *       *           #
# #*# # #  # # # #*# # # # # # #
#            *   *  *          #
################################