5 13 31
##############################
#p    **      *      *  *    #
# # # #*# # # # # # # # # # ##
#   *   *  2  *  *   *    *  #
# # # # # # # # # # # # # # ##
# *     *    *    4  *  **   #
# # # # # # # # # # # # # # ##
#    *  3  *   6     *  5    #
# # # # # # # # # # # # # # ##
#  * * *     *    *     6    #
# # # # # # # # # # # # # # ##
#    *      *             *  #
##############################