1 13 31
##############################
#p     ** *    * 1 *  * * *  #
# # # #*# #*#*#*# # # #*#*#*##
#        1***  *      *   * *#
# # # # # #*# # #*#*# # # # ##
#   1        **  *  *        #
# # # # # # # # # #*# #*# # ##
#*  *      *  *     2*       #
# # # # #*# # # #*#*# # # # ##
#*    **  *       *    x3    #
# #*# # # # # # #*# # # # # ##
#        2  *   *  *    2    #
##############################