1 13 31
##############################
#p t s ** *    *   *  * * *  #
# # # #*# # #*#*# # # #*#*#*##
#   *    2***  *  1   *   * *#
#f# # # # #*# # #*#*# # # # ##
#          x **  *  *   1    #
# # # # # # # # # #*# #*# # ##
#*  *      *  *      *       #
# # # # #*# # # #*#*# # # # ##
#*    **  *       *          #
# #*# # # # # # #*# # # # # ##
#        2  *   *  *         #
##############################