1 13 31
##############################
#p     ** *    *   *  * * *  #
# # # #*# # #*#*# # # #*#*#*##
# s *   5 ***  *      *   * *#
#f# # # # #*# # #*#*# # # # ##
#    6 t   x **  *  *   1    #
# # # # # # # # # #*# #*# # ##
#*  *      * 4*      *       #
# # # # #*# # # #*#*# # # # ##
#*    **  *       *          #
# #*# # # # # # #*# # # # # ##
#           *   *  *         #
##############################