1 13 31
##############################
#p  1  **2*  1 *   *  * * *  #
# # # #*# # #*#*# # # #*#*#*##
#   *3   2***  *  1   *   * *#
# # # # # #*# # #*#*# # # # ##
#f   2   3 x **  *  *   1    #
# # # # # # # # # #*# #*# # ##
#*  *   2  *  *      *       #
# # # # #*# # # #*#*# # # # ##
#*    **  *       *          #
# #*# # # # # # #*# # # # # ##
#        2  *   *  *         #
##############################