4 13 32
################################
#p  x 1 * *    *   **  * *     #
# # # #*# # #*#*# ## # #*#*#*# #
#  f      ***  *   *   *   * * #
# # # # # #*# # #*##*# # # # #*#
# *          **  *   *         #
# # # # # # # # # ##*# #*# # # #
#*  f      *  *       *        #
# # # # #*# # # #*##*# # # # # #
#*    **  *       **           #
# #*# # # # # # #*## #b# # # # #
#    **     *   *   *          #
################################