5 13 30
##############################
#p                           #
# # # #*# # # ## # # # # # # #
#      x                     #
# # # # # # # ## # # # # # # #
#                            #
# # # # # # # ## # # # # # # #
#                            #
# # # # # # # ## # # #1# # # #
#               2            #
# # # # # # # ## # # # # # # #
#                            #
##############################